20
9
X X X X X X X X X X X X X X X X X X X X 
A - - - - - - - - - - - - - - - - - - A 
A - - - - - - - - - - - - - - - - - - A 
A - - - - - - - - - - - - - - - - - - A 
A - S - - - - - - - - - - - - - - A A A 
- - - - - - - - - S1 - - - - - - - - A A 
A A A A A A A A A A A A A A A A A A A A 
A A A A A A A A A A A A A A A A A A A A 
X X X X X X X X X X X X X X X X X X X X 