12
8
TT TT TT TT TT TT TT TT TT TT TT TT 
TT -- -- -- -- -- -- -- -- -- -- TT 
TT -- -- -- -- -- -- -- -- -- -- TT 
TT SS -- -- -- -- -- -- -- -- -- TT 
TT -- -- -- -- AA -- -- -- E1 -- TT 
AA AA AA AA AA AA -- -- AA AA AA AA 
AA AA AA AA AA AA -- -- AA AA AA AA 
XX XX XX XX XX XX XX XX XX XX XX XX